 , , , , , , , , , , , , , , , , , , , , , , , , , , , ,
 ,.,.,.,.,.,.,.,.,.,.,.,., , ,.,.,.,.,.,.,.,.,.,.,.,., ,
 ,., , , , ,., , , , , ,., , ,., , , , , ,., , , , ,., ,
 ,P, , , , ,., , , , , ,., , ,., , , , , ,., , , , ,P, ,
 ,., , , , ,., , , , , ,., , ,., , , , , ,., , , , ,., ,
 ,.,.,.,.,.,.,.,.,.,.,.,.,.,.,.,.,.,.,.,.,.,.,.,.,.,., ,
 ,., , , , ,., , ,., , , , , , , , ,., , ,., , , , ,., ,
 ,., , , , ,., , ,., , , , , , , , ,., , ,., , , , ,., ,
 ,.,.,.,.,.,., , ,.,.,.,., , ,.,.,.,., , ,.,.,.,.,.,., ,
 , , , , , ,., , , , , , , , , , , , , , ,., , , , , , ,
 , , , , , ,., , , , , , , , , , , , , , ,., , , , , , ,
 , , , , , ,., , , , , , , , , , , , , , ,., , , , , , ,
 , , , , , ,., , , , , , , , , , , , , , ,., , , , , , ,
 , , , , , ,., , , , , , , , , , , , , , ,., , , , , , ,
 , , , , , ,., , , , , , , , , , , , , , ,., , , , , , ,
 , , , , , ,., , , , , , , , , , , , , , ,., , , , , , ,
 , , , , , ,., , , , , , , , , , , , , , ,., , , , , , ,
 , , , , , ,., , , , , , , , , , , , , , ,., , , , , , ,
 , , , , , ,., , , , , , , , , , , , , , ,., , , , , , ,
 , , , , , ,., , , , , , , , , , , , , , ,., , , , , , ,
 ,.,.,.,.,.,.,.,.,.,.,.,., , ,.,.,.,.,.,.,.,.,.,.,.,., ,
 ,., , , , ,., , , , , ,., , ,., , , , , ,., , , , ,., ,
 ,., , , , ,., , , , , ,., , ,., , , , , ,., , , , ,., ,
 ,P,.,., , ,.,.,.,.,.,.,.,.,.,.,.,.,.,.,.,., , ,.,.,P, ,
 , , ,., , ,., , ,., , , , , , , , ,., , ,., , ,., , , ,
 , , ,., , ,., , ,., , , , , , , , ,., , ,., , ,., , , ,
 ,.,.,.,.,.,., , ,.,.,.,., , ,.,.,.,., , ,.,.,.,.,.,., ,
 ,., , , , , , , , , , ,., , ,., , , , , , , , , , ,., ,
 ,., , , , , , , , , , ,., , ,., , , , , , , , , , ,., ,
 ,.,.,.,.,.,.,.,.,.,.,.,.,.,.,.,.,.,.,.,.,.,.,.,.,.,., ,
 , , , , , , , , , , , , , , , , , , , , , , , , , , , ,
